33330000033333333333333333333333333333333333333333333333300000000000000000
33300000000033333333333333333333333333333333000000000000000000000000000000
33000000000000033333333333333333300000000000000000000000000000000000000000
30000000000000003333333000000333000000000000000000000000000000000000000000
30000000000000000333000000000003000000000000000000000000000000000000000000
00000000000000000330000000000000000040000000000000000000000000000000000000
00000000000400000030000000000000000000000000000000000000000000000000000000
00000000000000000000000000000000000000000000000000000000000000000000000000
00400000000000000000000000000000000000055555555000000000000000000000000000
00000000000000000000000000000000000033333333333333333300000000000000000000
00000000000000110000000000000000000000003000000030000000000000110000000000
00000000000001110000000000000000000000003000000033000000000001221100000000
00000000000011210000000000000000000033003000000003033000001112222211100000
11111111111112210000001111111111111111111111111111111111111222222222111111
22222222222222210000001222222222222222222222222222222222222222222222222222
22222222222222210000001222222222222222222222222222222222222222222222222222
22222222222222210000001222222222222222222222222222222222222222222222222222
22222222222222210000001222222222222222222222222222222222222222222222222222
22222222222222210000001222222222222222222222222222222222222222222222222222
22222222222222210000001222222222222222222222222222222222222222222222222222
22222222222222210000001222222222222222222222222222222222222222222222222222
22222222222222216666661222222222222222222222222222222222222222222222222222