00000000000000000000000000000000000
00000000000000000000000000000000000
00000000000000000000000000000000000
00000000000000000000000000000000000
00000000000000000000000000000000000
00000000000000000000000000000000000
00000000000000000000000000000000000
00000000000000000000000000000000000
00000000000000000000000000000000000
00000000000000000000000000000000000
00000000000000110000000000000000000
00000000000001110000000000000000000
00000000000011210000000000000000000
11111111111112210000001111111111111
22222222222222210000001222222222222
22222222222222210000001222222222222