33330000033333333333333333333333333333333333333333333333333330000000000000
33300000000000033333333333333333333333333333333300000000000000000000000000
33000000000000000033333333333333333330000000000000000000000000000000000000
30000000000000000000333333300000033300000000000000000000000000000000000000
30000000000000000000033300000000000300000000000000000000000000000000000000
00000000000400000000033000000000000000004000000000000000000000000000000000
00000000000000000000003000000000000000000000000000000000000000000000000000
00000000000000000000000000000000000000000000555000000000000000000000000000
00400000000000000000000077700000000000005555222550000000000000000000000000
00000000000000000000000000000000000000333333333333333300000000000000000000
00003300000000110000000000000000000003303000000030000000000000110000000000
00003000000001110000000000000000003000003000000033000000000001221100000000
00033300000011210000000000000000000033003000000003033000001112222211100000
11111111111112210000001111111111111111111111111111111111111222222222111111
22222222222222210000001222222222222222222222222222222222222222222222222222
22222222222222210000001222222222222222222222222222222222222222222222222222
22222222222222210000001222222222222222222222222222222222222222222222222222
22222222222222210000001222222222222222222222222222222222222222222222222222
22222222222222210000001222222222222222222222222222222222222222222222222222
22222222222222210000001222222222222222222222222222222222222222222222222222
22222222222222210000001222222222222222222222222222222222222222222222222222
22222222222222210000001222222222222222222222222222222222222222222222222222