333333333333333333333333333333333333333333333333333333333333333333333333333333333333333333333333333333333333333
333333333333333333333333333333333333333333333333333333333333333333333333333333333333333333333333333333333333333
333333000000000333333333333333333000000000000000000000000000000000000000000000000000000000000000055500000333333
333333000000000033333330000003330000000000000000000000000000000000011222000000000000000000000000055500000333333
333333000000000003330000000000030000000000000000000000000000000000021112000000000000000000000000055500000333333
333333000000000003300000000000000000000000000000000000000000000000021112000000000000000000000000000000000333333
333333000000000000300000000000000000000000000000000000000000000000011122000000000000000000000000000000000333333
333333000000000000000000000000000000000000000000000000000000000000022222000000000000000000000000000000003333333
333333000000000000000000000000000000000000000000000000000000000000000000000000000000000000000000000000333333333
333333000000000000000000000000000000000000000000000000000000000000000000000000000000000000000000000000333333333
333333000000000000000000000000000000000000000000000000000000000000000000000000000000000000000000000000333333333
333333000000000000000000000000000000000000000000000000000000000000000000000000000000000000000000000000333333333
333333000000000000000000000000000000000000000000000000000000000000000000000000000000000000000000000000333333333
333333000000000000000000000000000000000000000000000000000000000000000000000000000000000000000000000000333333333
333333000000000000000000000000000000000000000000000000000000000000000000000000000000000000000000000000333333333
333333000000000000000000000000000000000000000000000000000000000000000000000000000000000000000000000000333333333
333333000000000000000000000000000000000000000000000000000000000000000000000000000000000000000000000000333333333
333333000000000000000000000000000000000000000000000000000000000000000000000000000000000000000000000000333333333
333333000000000000000000000000000000000000000000000000000000000000000000000000000000000000000000000000333333333
333333000000000000000000000000000000000000000000000000000000000000000000000000000000000000000000000000333333333
333333000000000000000000000000000000000000000000000000000000000000000000000000000000000000000000000000333333333
333333000000000000000000000000000000000000000000000000000000000000000000000000000000000000000000000000333333333
333333000000000000000000000000000000000000000000000000000000000000000000000000000000000000000000000000333333333
333333000000000000000000000000000000000000000000000000000000000000000000000000000000000000000000000000333333333
333333000000000000000000000000000000000000000000000000000000000000000000000000000000000000000000000000333333333
333333000000000000000000000000000000000000000000000000000000000000000000000000000000000000000000000000333333333
333333000000000000000000000000000000000000000000000000000000000000000000000000000000000000000000000000333333333
333333000000000000000000000000000000000000000000000000000000000000000000000000000000000000000333333333333333333
333333000000000000000005550000000000000000000000000000000000000000000000000000000000000333333333333333333333333
333333000000000000000005550000000000000000000000000000000555500000000000000000000000000000000000000003333333333
333333000000000000000005550000000000000000000000000000000555500000000000000000000000000000000000000000033333333
333333005550000000000000000000000000000000000000000000000555500000000000000000000000000000000000000000003333333
333333005550000000000000000000000000000000000000000000000000000000000000000000000000000000000000000000003333333
333333005550000000000000000000000000000000000000003333333333333333333333333333333333330000000000000000003333333
333333300000000000000000000000000000000000000000000000000005550000122200000000000330033000000000000000003333333
333333333300000000000000000000000000000000000000000000000000000000000000000000000330033300000000000000000333333
333333333333333000000000000000000000000000000000000000000005550003300000000000000000333000000000000000000333333
333333333333333300000000000000000000000000000000003333333333333333333333333333333333330000000000000000000333333
333333333333333333333333333333333333333333333333333333333333333333333333333333333333333333333333333333333333333
333333333333333333333333333333333333333333333333333333333333333333333333333333333333333333333333333333333333333